NO ./textures/north.xpm
SO ./textures/south.xpm
WE ./textures/west.xpm
EA ./textures/east.xpm
F 200,100,50
C 10,10,80

111111111111111
100000000000001
100000000000001
100000000000001
1000000S0000001
100000000000001
100000000000001
111111111111111
