NO ./textures/north.xpm
SO ./textures/south.xpm
WE ./textures/west.xpm
EA ./textures/east.xpm
F 10,200,10
C 0,0,0

1111111111
1000000001
10000E0001
1000000001
1111111111
