NO ./textures/north.xpm
SO ./textures/south.xpm
WE ./textures/west.xpm
EA ./textures/east.xpm
F 50,50,50
C 200,200,200

111111111111111111
100000000000000001
100000001000000001
100000001000000001
100000001000000001
100000001000000001
10000000100000N001
111111111000000001
       10000000001
       11111111111
