NO ./textures/north.xpm
SO ./textures/south.xpm
WE ./textures/west.xpm
EA ./textures/east.xpm
F 0,0,0
C 255,255,255

1111111111111111
1000000000000001
1011111111111001
1010000000001001
1010111110001001
101011N110001001
1010111110001001
1010000000001001
1011111111111001
1000000000000001
1111111111111111
