NO ./textures/north.xpm
SO ./textures/south.xpm
WE ./textures/west.xpm
EA ./textures/east.xpm
F 255,128,0
C 20,20,20

111111111
100000001
100000001
100100001
100100001
1001000N1
100100001
100000001
111111111
