NO ./textures/north.xpm
SO ./textures/south.xpm
WE ./textures/west.xpm
EA ./textures/east.xpm
F 50,50,50
C 50,50,50

111111
100001
100001
100001
111111
